1111111111
1     1  1
1 111   11
1 1 1 1  1
1 1 1111 1
1    1   1
1 11 1 1 1
1 11 1 1 1
1   i1o1 1
1111111111
