111111111111111111111111111111
1                            1
1                            1
1  i     1              o    1
1        1oo            oo   1
1        1111                1
1                  1111      1
1                            1
1          111               1
1         11oo               1
1         11o                1
1          1         oo      1
1                     oo     1
1    1              ooo      1
1    11                      1
1    1            11         1
1                  11        1
1                            1
1                            1
111111111111111111111111111111
