111111111111111111111111111111
1                            1
1                            1
1        1oo            o    1
1    o   1oo            oo   1
1    o   1111       oo       1
1   oo             1111      1
1                            1
1          1 1 1             1
1         oo 1i              1
1       111 1111           oo1
1            1              o1
1                           11
1    1                111    1
1    11              11 11   1
1  oo1              11o o1   1
1  oo               1oo o1   1
1                      oo1   1
1                            1
111111111111111111111111111111
