11111111111111111111111111111111111111111111111
1        1     1                              1
1        1            1111111                 1
1        1                                    1
1        1                   11               1
1    1    1                              11   1
1    11            1111                       1
1                               11111         1
1    1     111                                1
111111    11                                  1
1   1     11            i                     1
1          1                11111             1
1    11111                                    1
1    1      1             11                  1
1    11                    1       o          1
1                  11                         1
1                                             1
1                                  1          1
11                                            1
11111111111111111111111111111111111111111111111